1 13 31
###############################
#p      * *    *   *  * * *   #
#*# #s#* *# #*#*# # # #*#*#*# #
# 1  3 *  ***  *      *   * * #
#*#*#*#*#*#*# # #*#*# # # # #*#
#f   3     x **  *  *         #
#*# #s#*# # # # # #*# #*#*# # #
#   *   2  *  *      *    *   #
# #b#*# #*# # # #*#*# # #*# #*#
#* 2  **  *    f  *    *      #
# #b# # # # # # #*# #*# # # #*#
#   3    f  *   *  *          #
###############################